27 21
*********************
*.........*.........*
*.***.***.*.***.*** *
*B***.***.*.***.***B*
*.***.***.*.***.*** *
*...................*
*.***.*.*****.*.***.*
*.***.*.*****.*.***.*
*.....*...*...*.....*
*****.***.*.***.*****
    *.*.......*.*    
    *.*.** **.*.*    
*****.*.*F F*.*.*****
........*F F*........
*****.*.*****.*.*****
    *.*.......*.*    
    *.*.*****.*.*    
*****.*.*****.*.*****
*.........*.........*
*.***.***.*.***.***.*
*B..*.....P.....*..B*
***.*.* *****.*.*.***
***.*.* *****.*.*.***
*.....*...*...*.....*
*.*******.*.*******.*
*...................*
*********************
